肖申克的救赎	美国
霸王别姬	中国大陆
阿甘正传	美国
这个杀手不太冷	法国
美丽人生	意大利
泰坦尼克号	美国
千与千寻	日本
辛德勒的名单	美国
盗梦空间	美国
忠犬八公的故事	美国
海上钢琴师	意大利
机器人总动员	美国
三傻大闹宝莱坞	印度
楚门的世界	美国
放牛班的春天	法国
星际穿越	美国
大话西游之大圣娶亲	中国香港
熔炉	韩国
龙猫	日本
无间道	中国香港
活着	美国
控方证人	中国大陆
乱世佳人	美国
少年派的奇幻漂流	美国
飞屋环游记	美国
鬼子来了	印度
十二怒汉	美国
天空之城	美国
寻梦环游记	中国大陆
末代皇帝	美国
天堂电影院	日本
大话西游之月光宝盒	美国
哈尔的移动城堡	英国
罗马假日	意大利
搏击俱乐部	中国香港
闻香识女人	日本
素媛	美国
辩护人	美国
何以为家	美国
窃听风暴	韩国
两杆大烟枪	英国
飞越疯人院	美国
狮子王	美国
美丽心灵	美国
饮食男女	新西兰
大闹天宫	美国
钢琴家	美国
海豚湾	中国台湾
黑客帝国	中国大陆
情书	美国
看不见的客人	法国
让子弹飞	美国
我不是药神	美国
西西里的美丽传说	美国
猫鼠游戏	日本
小鞋子	西班牙
拯救大兵瑞恩	中国大陆
美国往事	中国大陆
音乐之声	意大利
致命魔术	美国
七宗罪	美国
低俗小说	美国
穿条纹睡衣的男孩	英国
被嫌弃的松子的一生	日本
沉默的羔羊	美国
蝴蝶效应	美国
春光乍泄	中国香港
心灵捕手	美国
禁闭岛	美国
勇敢的心	美国
布达佩斯大饭店	美国
剪刀手爱德华	美国
天使爱美丽	法国
阿凡达	美国
摩登时代	美国
加勒比海盗	美国
幽灵公主	美国
断背山	日本
入殓师	美国
喜剧之王	日本
海蒂和爷爷	德国
杀人回忆	韩国
玛丽和马克思	澳大利亚
消失的爱人	日本
请以你的名字呼唤我	美国
告白	意大利
一一	日本
大鱼	中国台湾
爱在黎明破晓前	美国
红辣椒	美国
阳光姐妹淘	日本
侧耳倾听	韩国
射雕英雄传之东成西就	日本
甜蜜蜜	韩国
超脱	中国香港
倩女幽魂	中国香港
驯龙高手	美国
菊次郎的夏天	美国
恐怖直播	中国香港
爱在日落黄昏时	日本
唐伯虎点秋香	中国香港
萤火之森	日本
幸福终点站	美国
超能陆战队	美国
借东西的小人阿莉埃蒂	日本
风之谷	日本
无人知晓	日本
神偷奶爸	美国
上帝之城	巴西
绿皮书	美国
怪兽电力公司	美国
血战钢锯岭	美国
电锯惊魂	美国
岁月神偷	美国
喜宴	中国香港
七武士	中国台湾
时空恋旅人	日本
英雄本色	美国
完美的世界	英国
傲慢与偏见	中国香港
爆裂鼓手	美国
真爱至上	美国
被解救的姜戈	英国
心迷宫	美国
纵横四海	中国大陆
贫民窟的百万富翁	中国香港
记忆碎片	英国
黑天鹅	美国
三块广告牌	美国
荒蛮故事	美国
达拉斯买家俱乐部	阿根廷
哪吒闹海	美国
我是山姆	中国大陆
花样年华	美国
雨人	日本
卢旺达饭店	中国香港
天书奇谭	美国
头号玩家	英国
头脑特工队	中国大陆
你看起来好像很好吃	美国
未麻的部屋	日本
恋恋笔记本	美国
忠犬八公物语	日本
冰川时代	美国
一个叫欧维的男人决定去死	瑞典
模仿游戏	英国
二十二	中国大陆
虎口脱险	法国
雨中曲	美国
海洋	美国
海街日记	法国
人工智能	日本
房间	美国
魔女宅急便	爱尔兰
恐怖游轮	日本
燃情岁月	英国
惊魂记	美国
穿越时空的少女	美国
罗生门	日本
魂断蓝桥	日本
猜火车	英国
人生果实	美国
阿飞正传	日本
可可西里	中国香港
香水	中国大陆
初恋这件小事	德国
牯岭街少年杀人事件	泰国
新世界	中国台湾
谍影重重	韩国
战争之王	美国
爱在午夜降临前	英国
地球上的星星	美国
青蛇	美国
浪潮	美国
朗读者	印度
新龙门客栈	中国香港
无耻混蛋	德国
源代码	美国
绿里奇迹	中国香港
步履不停	德国
血钻	美国
城市之光	美国
再次出发之纽约遇见你	美国
彗星来的那一夜	美国
追随	英国
一次别离	澳大利亚
东京物语	美国
聚焦	伊朗
遗愿清单	日本
小偷家族	美国
撞车	美国
发条橙	日本
梦之安魂曲	美国
黑鹰坠落	英国
驴得水	中国台湾
大佛普拉斯	美国
我爱你	美国
末路狂花	中国大陆
千钧一发	中国台湾
变脸	韩国
